544444444444445
511111111111115
514141414141415
511111111111115
514141414141415
511111111111115
514141414141415
511111111111115
514141414141415
511111111111115
514141414141415
511111111111115
444444444444444